1111111111111111111111111111111
          1      11111111     1
          1                   1
          1                   1
          1                   1
                              1
1111111111111 11111111        1
              1               1
              1               1
              1               1
              1               1
              1               1
              1               1
              1               1
              1               1
        11111111111111        1
                              1
                              1
                              1
1111111111111111111111111111111                        
